555555555555555555555555
555555555555555555555555
555555555555555555555555
000000000@00000000000000
666666666666666666666666
3......3..3..3....3..3..
..3.......3..3.......3..
.33....3.3..33....3.33..
.3......33..3......33...
..3....33...3.....33....
.22...333...334..333....
................2.......
.....3...22.....2...33..
..........3..........3..
33...................3..
33...................3..
