555555555555555555555555
555555555555555555555555
555555555555555555555555
000000000@00000000000000
666666666666666666666666
.3.....33..3....3.3.3...
............2.......3...
23............3.3.3.33..
.3......23..3......33...
..3....33...3.....33....
.22...333...3.3.....3...
..33........323.....3...
..2....3..........3.....
...2..3...3343....3.3...
.2.3................3...
......33....22..........
